1111111111
10E00000C1
100C0P0001
101100C101
1000000001
1111111111