11111111111111
10C000P1000101
1C00000100E001
10000000000001
11111111111111